MouseIslandTest
7

7
8

-1 -1 -1 14 -1 -1 -1 -1
-1  1  4 -1 -1 -1 -1 -1
-1 -1 -1 -2 -1 -1 -1 -1
-1 -1 -1  3 -1 -1 -1 -1
-1 -1 -1  0 -1 -1 -1 -1
-1 -1 -1 -1 -1 -1 -1 -1
-1 -1 -1 -1 -1 -1 -1 -1
