MouseIslandTest
2

10
8

-1 -1 -1 14  1 -1 -1 -1
-1  1  4  1  1  1 -1 -1
-1  1  1  1  1  1  1 -1
-1  1  1  1  a  1 22 -1
-1  1  1  1  1  1  1 -1
-1  1  1  3  1  4  1 -1
-1  1  1  1  1  1  1 -1
-1  1  5  1  6  3  1 -1
-1  1  1 -1  1  1  1 -1
-1 -1  1 -1 -1  1 -1 -1
